Template_RC	outfile_tRNA	tRNA_count
TTT	AAA	
TTC	GAA	
TTA	TAA	
TTG	CAA	
TCT	AGA	
TCC	GGA	
TCA	TGA	
TCG	CGA	
TAT	ATA	
TAC	GTA	
TAA	TTA	
TAG	CTA	
TGT	ACA	
TGC	GCA	
TGA	TCA	
TGG	CCA	
CTT	AAG	
CTC	GAG	
CTA	TAG	
CTG	CAG	
CCT	AGG	
CCC	GGG	
CCA	TGG	
CCG	CGG	
CAT	ATG	
CAC	GTG	
CAA	TTG	
CAG	CTG	
CGT	ACG	
CGC	GCG	
CGA	TCG	
CGG	CCG	
ATT	AAT	
ATC	GAT	
ATA	TAT	
ATG	CAT	
ACT	AGT	
ACC	GGT	
ACA	TGT	
ACG	CGT	
AAT	ATT	
AAC	GTT	
AAA	TTT	
AAG	CTT	
AGT	ACT	
AGC	GCT	
AGA	TCT	
AGG	CCT	
GTT	AAC	
GTC	GAC	
GTA	TAC	
GTG	CAC	
GCT	AGC	
GCC	GGC	
GCA	TGC	
GCG	CGC	
GAT	ATC	
GAC	GTC	
GAA	TTC	
GAG	CTC	
GGT	ACC	
GGC	GCC	
GGA	TCC	
GGG	CCC	
